1 13 31
###############################
#p   x ** * 2  * * *  * * *   #
# & & &*& & &*&*& & & &*&*&*& #
#   * 1   ***  *      *   * * #
#b& & & & &*& & &*&*& & & & &*#
#f       s   **  *  *         #
# & & & & & & & & &*& &*& & & #
#*  *      *  *      *    1   #
# & & & &*& & & &*&*& & & & & #
#*    **  *  2    *           #
# &*& & & & & & &*& & & & & & #
#        1  *   *  *          #
###############################