4 13 31
###############################
#p    * **    *   3   4   b   #
# # # #*# # # # # # # # # # # #
#  s   ** * *  *   * ** 3 *   #
# # # # # #*# # # # # # #*# # #
#*   * *    *b* *   **        #
# # # # # # # # # # # # # #*# #
#    *     *        *    **  3#
# #*# # #*#*#*#*# # #1# # #*# #
#    f   * 4 *2*    *   *     #
#*# # # # # # # # # # #*# # #*#
#x*    * **    ** *** f   1   #
###############################