1 13 31
###############################
#p  r  ** *    * * *  * * *   #
# & & &*& & &*&*& & & &*&*&*& #
#   * 1   ***  *      *   * * #
#b&1& & & &*& & &*&*& & & & &*#
#f       s   **  *  *         #
# & & & & & & & & &*& &*& & & #
#*  *      *  *      *    1   #
# & & & &*& & & &*&*& & & & & #
#*    **  *  2    *           #
# &*& & & & & & &*& & & & & & #
#        1  *   *  *  x    1  #
###############################