2 13 31
&##############################
 p * *2       *  ** * *  1   *#
& &&&   &&&   &&&** &&&   &&& #
# q  * * *** **      *    **  #
# &*& & & & &1& &b&1& & & & &*#
#      3   *     **      *  **#
# &&&   &&&   &&&   &&&   &&& #
#   *  fb    *   * *x* *      #
# & & & &*& & & & & & &*& &*& #
#   ****    j    *1    **     #
# &&&   &&&   &&&   &&&   &&&*#
#  ** *   *    2       s 1    #
###############################