3 13 31
###############################
#p   ** **    *   2    ff     #
# # # #*# # # # # # # # # # # #
#*     ** * *  *   * ** 3 *   #
# # # # # #*# # # # # # #*# # #
#*   *s*  4 *** * x **   b    #
# # # # # # # # # # # # # #*# #
#    *     *     5  *    **   #
# #*# # #*#*#*#*# # #1# # #*# #
#     b  *   * *    *   *     #
#*# # # # # # # # # # #*# # #*#
# *    * **    ** ***   b 1   #
###############################