5 13 31
###############################
#p * *3   9   *  ** * *   s  *#
# # # # #*# # #*# # # # # #*# #
#    * * *** **  5   * 9  **  #
# #*# # # # #4# #b#1# # # # #*#
#     f    *  7  **   7  *  **#
# # #*# # # # # #*#*#*#*# # # #
# 7 *    8   *   * *x* *   4  #
# # # # #*# # # # # # #*# #*# #
#   ****  b      *9           #
# # # # # # # # # #*# # # # #*#
#  ** *5  *    2     8 f8b    #
###############################