4 13 31
###############################
#p    * **    * 11    4   b   #
# # # #*# # # # # # # # # # # #
#  s   ** * *  *   * ** 7 *   #
# # # # # #*# # # # # # #*# # #
#*   * *    *b* *   **        #
# # # # # # # # # # # # # #*# #
#    *  3  *   6    *    **  3#
# #*# # #*#*#*#*# # #1# # #*# #
#    f   * 7 *2*    *   *     #
#*# # # # # # # # # # #*# # #*#
#x* 5  * **    ** *** f   7   #
###############################