1 13 31
###############################
#p     ** *    * * *  * * *   #
# # # #*# # #*#*# # # #*#*#*# #
# s *       *  *  11  *   * * #
# # # # # #*# # #*#*# # # # #*#
#f      1     **  *  *      1 #
# # # # # # # # # #*# #*# # # #
#*  *  1   *  *  b   *    b   #
# # # # #*# # # #*#*# # # # # #
#*    **  *       *     2     #
# #*# # # # # # # # # # # # # #
#    1     2*   *  *      x   #
###############################