5 13 31
&&&&&&&&&&&&&&&&&&&&&&&&&&&&&&&
#p * *3   9   *  ** * *77 s  *#
# ###   #*# # #*# # # # # #*# #
#    * * rwj **  5   * 9  **  #
# #*#     ###4# #b#1#       #*#
#     f    *  7  **   7  *  **#
# # #*# # ##### #*#*#*#*      #
# 7 *    8   *   * *x* *   4  #
#       #*###     # # #*# #*# #
#   ****  b   8  *9       11  #
#       #####     #*# ##### #*#
#  ** *5  *    2     8 f8b    #
&&&&&&&&&&&&&&&&&&&&&&&&&&&&&&&