1 13 31
###############################
#p     ** *  1 * * *  * * *   #
# # # #*# # #*#*# # # #*#*#*# #
# b1*     ***  *  1   * 1 * * #
# # # # # #*# # #*#*# # # # #*#
#f1          **  *  *   1     #
# # # # # # # # # #*# #*# # # #
#*  *      *  *      *        #
# # # # #*# # # #*#*# # # # # #
#*    ** b*       *     s     #
# #*# # # # # # #*# # # # # # #
#      1    *   *  *  x  1    #
###############################