6 13 31
###############################
#p  r bf sw j     * * *  * * *#
#q                   &&&& &&&&#
# &&&&&&&&&&&&&&&     *   * * #
#b& & & & &*& & &*&*& & & & &*#
#f  ##  ###  **  *  *         #
# && &&    &&   &&& & &*& & & #
#*  *      *  *     * ********#
# & ####    &&&&       79 123 #
#*    **  *  2    *     456 8 #
#                             #
#   23456789  *   *  *  x     #
###############################