3 13 31
###############################
#p   ** **    *   2    ff     #
# # # #*# # # # # # # # # # # #
#*     ** * *  *   * ** 3 *   #
# # # # # #*# # # # # # #*# # #
#*   *s*    *** * x **   b    #
# # # # # # # # # # # # # #*# #
#    *     *        *    **  3#
# #*# # #*#*#*#*# # #1# # #*# #
#     b  *   *2*    *   *     #
#*# # # # # # # # # # #*# # #*#
# *    * **    ** ***   b 1   #
###############################