6 13 31
###############################
#pq r bf sw j     * * *  * * *#
#                    &&&& &&&&#
# &&&&&&&&&&&&&&&     *   * * #
#b& & & & &*& & &*&*& & & & &*#
#f  ##  ###  **  *  *         #
# && &&    &&   &&& & &*& & & #
#*  *      *  *     * ********#
# & ####    &&&&       79 123 #
#*    **  *  2    *     456 8 #
#                             #
#q  23456789  *   *  *  x     #
###############################