1 13 31
###############################
#p  s  ** *    * * *  * * *   #
# & & &*& & &*&*& & & &*&*&*& #
#  x*     ***  *      *   * * #
#b&1& & & &*& & &*&*& & & & &*#
#f           **  *  *         #
# & & & & & & & & &*& &*& & & #
#*  *      *  *      *        #
# & & & &*& & & &*&*& & & & & #
#*    **  *       *           #
# &*& & & & & & &*& & & & & & #
#q          *   *  *  x       #
###############################