1 13 31
###############################
#p     ** *  1 * * *  * * *   #
# # # #*# # #*#*# # # #*#*#*# #
#  x*   1 ***  *  1   * 1 * * #
# # # # # #*# # #*#*# # # # #*#
#f1  2543    **  *  *   1     #
# # # # # # # # # #*# #*# # # #
#*  *      *  *      *        #
# # # # #*# # # #*#*# # # # # #
#*    **  *       *           #
# #*# # # # # # #*# # # # # # #
#      1    *   *  *  x       #
###############################