3 13 31
&##############################
 p   ** **  r *   2   6 f     #
& & & & & & & & & & & & & & & #
#*     ** * *  *   * ** 3 *   #
# & # # # #*# # # # # # #*# & #
#*   *s*  4 *** * x **   b    #
# & # &&   &&   &&   &&   #*& #
#    *   w *     5  *    **   #
# &*# # #*#*#*#*# # #1# # #*& #
#     b  *   * *    *   *     #
#*& & & & & & & & & & & & & &*#
# *    * **    ** ***   j 1   #
###############################